Azura's Temple Entrance
bluebrick
9 16
/--------------\
|P.....|...|...|
|-\..|.|...|...|
|.|..|.|.--J...|
|.|x.|.|.......|
|.|....|-.|..x.|
|.L---.|..---..|
|..........x...|
L--------------J
