Azura's Temple Inner Sanctum
bluebrick
9 16
/--------------\
|..............|
|./--------\...|
|.|........|.x.|
|P|...x....|...|
|.|........L-.-|
|x|............|
|.|........x...|
L--------------J
