Azura's Cave
9 16
++++++++++++++++
+P.......+++...+
+.++++.+.+.+.+.+
+.+..+.+.+.+...+
+.+x.+.+....++.+
+.+....++.+..x.+
+.++++.+..+++..+
+......+...x...+
++++++++++++++++