Title Screen
bluebrick
9 16
/--------------\
|.........|....|
|.....x../J....|
J../\..........J
...||.x.x.|P....
\..LJ..........\
|.....x..L\....|
|.........|....|
L--------------J